---P--P---
--W-------
------P---
-----P----
---G------
W-----P---
---G------
P------W--
---P--P---
---------G
